Log Started: 2021-08-09 12:45:24.200101. Saving in out\makeCharts.txt.

Reading Market Info from MarketSet_v1.csv
Generating Summary Data
SPY      | US Large Cap         : S&P 500 
IWM      | US Small Cap         : R2000 
BTC-USD  | CRIPTO               : Bitcoin to US Dollar 
ETH-USD  | CRIPTO               : Ethereum to US Dollar 
IPO      | IPO                  : Renaissance IPO ETF 
ARKK     | NEW                  : ARK Innovation ETF 
BLCN     | NEW                  : Reality Shares Nasdaq NextGen Economy ETF 
FITE     | NEW                  : SPDR S&P Kensho Future Security ETF 
FM       | NEW                  : iShares MSCI Frontier 100 ETF 
IZRL     | NEW                  : ARK Israel Innovative Technology ETF 
KOMP     | NEW                  : SPDR Kensho New Economies Composite ETF 
LOUP     | NEW                  : Innovator Loup Frontier Tech ETF 
MARA     | NEW                  : Marathon Digital Holdings Inc 
MOON     | NEW                  : Direxion Moonshot Innovators ETF 
PRNT     | NEW 3DPrint          : ARK 3D Printing ETF 
BBC      | NEW Bio              : Virtus LifeSci Biotech Clinical Trials ETF 
BIB      | NEW Bio              : ProShares Ultra NASDAQ Biotechnology 
BTEC     | NEW Bio              : Principal Healthcare Innovators Index 
LABU     | NEW Bio              : Direxion Daily S&P Biotech Bull 3x Shares 
XBI      | NEW Bio              : SPDR S&P Biotech ETF 
RIOT     | NEW Blockchain       : Riot Blockchain, Inc. 
RIGZ     | NEW Blockchain       : Mining companies & Semiconductors 
Exception Caught: Length of values (9) does not match length of index (15)
ACES     | NEW CleanEnergy      : ALPS Clean Energy ETF 
CNRG     | NEW CleanEnergy      : SPDR S&P Kensho Clean Power ETF 
ICLN     | NEW CleanEnergy      : iShares Global Clean Energy ETF 
KGRN     | NEW CleanEnergy      : KraneShares MSCI China Environment Index ETF 
PBW      | NEW CleanEnergy      : Invesco WilderHill Clean Energy ETF 
QCLN     | NEW CleanEnergy      : First Trust NASDAQ Clean Edge Green Energy Index Fund 
SMOG     | NEW CleanEnergy      : VanEck Vectors Low Carbon Energy ETF 
TAN      | NEW CleanEnergy      : Invesco Solar ETF 
BLOK     | NEW Cloud            : Amplify Transformational Data Sharing ETF 
CLDL     | NEW Cloud            : Direxion Daily Cloud Computing Bull 2X 
WCLD     | NEW Cloud            : WisdomTree Cloud Computing Fund 
UCYB     | NEW CyberSec         : ProShares Ultra Nasdaq Cybersecurity ETF 
EBIZ     | NEW Ebiz             : Global X e 
IBUY     | NEW EBiz             : Amplify Online Retail ETF 
ONLN     | NEW EBiz             : ProShares Online Retail ETF 
DRIV     | NEW Ecars            : Global X Autonomous & Electric Vehicles ETF 
EKAR     | NEW Ecars            : Innovation Shares NextGen Vehicles & Technology ETF 
ARKF     | NEW Fintech          : ARK Fintech Innovation ETF 
ARKG     | NEW Genom            : ARK Genomic Revolution Multi 
GNOM     | NEW Genom            : Global X Genomics & Biotechnology ETF 
IDNA     | NEW Genom            : iShares Genomics Immunology and Healthcare ETF 
LIT      | NEW Litheum          : Global X Lithium ETF 
IEME     | NEW Media            : iShares Evolved U.S. Media and Entertainment ETF 
PEJ      | NEW Media            : Invesco Dynamic Leisure and Entertainment ETF 
QTUM     | NEW QCompute         : Defiance Quantum ETF 
ARKQ     | NEW Robots           : ARK Autonomous Technology & Robotics ETF 
BOTZ     | NEW Robots           : Global X Robotics & Artificial Intelligence Thematic ETF 
IRBO     | New Robots           : iShares Robotics and Artificial Intelligence ETF 
ROBO     | NEW Robots           : ROBO Global Robotics and Automation Index ETF 
ROBT     | NEW Robots           : First Trust Artificial Intelligence and Robotics ETF 
UBOT     | NEW Robots           : Direxion Robotics Artificial Intelligence Bull 3X Shares 
BETZ     | NEW Sports           : Roundhill Sports Betting & iGaming ETF 
BJK      | NEW Sports           : VanEck Vectors Gaming ETF 
ESPO     | NEW Sports           : VanEck Vectors Video Gaming and eSports ETF 
HERO     | NEW Sports           : Global X Video Games & Esports ETF 
NERD     | NEW Sports           : Roundhill BITKRAFT Esports & Digital Entertainment ETF 
ARKW     | NEW Web              : ARK Web x.0 ETF 
FDN      | NEW Web              : First Trust Dow Jones Internet Index Fund 
PNQI     | NEW Web              : Invesco NASDAQ Internet ETF 
IYW      | TECH                 : iShares U.S. Technology ETF 
QQQ      | TECH                 : Invesco QQQ Trust 
EWCO     | TECH Communication   : Invesco S&P 500 EW Communication Services ETF 
VOX      | TECH COmmunication   : Vanguard Communication Services ETF 
DFEN     | TECH Defense         : Direxion Daily Aerospace & Defense Bull 3X Shares 
ITA      | TECH Defense         : iShares U.S. Aerospace & Defense ETF 
XAR      | TECH Defense         : SPDR S&P Aerospace & Defense ETF 
IFRA     | TECH Infrastructure  : iShares U.S. Infrastructure ETF 
PAVE     | TECH Infrastructure  : Global X U.S. Infrastructure Development ETF 
XVZ      | VIX                  : iPath S&P 500 Dynamic VIX ETN 
DWLD     | WORLD EQ             : Davis Select Worldwide ETF 
OGIG     | OIL                  : OSI ETF Trust 
CNBS     | POT                  : Amplify Seymour Cannabis ETF 
MJ       | POT                  : ETFMG Alternative Harvest ETF 
MJO      | POT                  : MicroSectors Cannabis 2X Leveraged ETN 
POTX     | POT                  : Global X Cannabis ETF 
THCX     | POT                  : The Cannabis ETF 
TOKE     | POT                  : Cambria Cannabis ETF 
YOLO     | POT                  : AdvisorShares Pure Cannabis ETF 
Saving Summary Data
Sending email subj MarketDrivers
Log Closed: 2021-08-09 12:50:03.781935
